state,year,pop_estimate,pop_change,births,deaths,international_mig,domestic_mig,net_mig,natural_inc,r_birth,r_death,r_natural_inc,r_international_mig,r_domestic_mig,r_net_mig
Alabama,2010,4785448,5310,14227,11073,928,1238,2166,3154,0,0,0,0,0,0
Alabama,2011,4798834,13386,59689,48818,4716,-2239,2477,10871,12.45560179,10.18709591,2.268505872,0.984111277,-0.467223314,0.516887963
Alabama,2012,4815564,16730,59070,48364,5874,59,5933,10706,12.28782083,10.06074431,2.227076516,1.221917379,0.012273259,1.234190638
Alabama,2013,4830460,14896,57936,50847,5111,2641,7752,7089,12.0124105,10.5425821,1.469828398,1.059711234,0.547583129,1.607294363
Alabama,2014,4842481,12021,58907,49692,3753,-755,2998,9215,12.17974968,10.27443463,1.905315043,0.775979095,-0.156105573,0.619873521
Alabama,2015,4853160,10679,59637,51820,4685,-1553,3132,7817,12.30181687,10.68933967,1.612477195,0.96641367,-0.320350145,0.646063525
Alabama,2016,4864745,11585,59388,51662,5950,-1977,3973,7726,12.22238744,10.63233279,1.590054647,1.224543767,-0.40687782,0.817665948
Alabama,2017,4875120,10375,58259,53033,3190,2065,5255,5226,11.96299949,10.889884,1.07311549,0.65503988,0.424030518,1.079070398
Alabama,2018,4887871,12751,57216,53425,3344,5718,9062,3791,11.72099821,10.94439194,0.776606268,0.685035969,1.171362342,1.856398311
Alaska,2010,713906,3657,2893,924,433,1162,1595,1969,0,0,0,0,0,0
Alaska,2011,722038,8132,11702,3936,1320,-979,341,7766,16.29868574,5.482107937,10.81657781,1.838511808,-1.363562924,0.474948884
Alaska,2012,730399,8361,11123,3935,2361,-1274,1087,7188,15.31632697,5.418479425,9.897847549,3.251087655,-1.754292957,1.496794698
Alaska,2013,737045,6646,11342,4046,2881,-3544,-663,7296,15.45817081,5.514350122,9.943820684,3.926555289,-4.830167284,-0.903611995
Alaska,2014,736307,-738,11446,4035,1213,-9593,-8380,7411,15.53735971,5.47730617,10.06005354,1.646585473,-13.02200696,-11.37542149
Alaska,2015,737547,1240,11335,4354,2306,-8178,-5872,6981,15.38144212,5.908319277,9.473122847,3.129210899,-11.0974357,-7.968224804
Alaska,2016,741504,3957,11247,4441,2282,-5175,-2893,6806,15.20840052,6.005201984,9.203198537,3.085762425,-6.997730301,-3.911967877
Alaska,2017,739786,-1718,10981,4586,2595,-10746,-8151,6395,14.8262663,6.191900303,8.634365992,3.503702854,-14.50897529,-11.00527243
Alaska,2018,737438,-2348,10693,4738,2401,-10752,-8351,5955,14.47715445,6.414734665,8.062419782,3.250691838,-14.557034,-11.30634217
Arizona,2010,6407774,15486,20942,11484,2709,3496,6205,9458,0,0,0,0,0,0
Arizona,2011,6473497,65723,86103,48157,17126,10583,27709,37946,13.36871183,7.477057194,5.891654636,2.659054374,1.643160834,4.302215208
Arizona,2012,6556629,83132,85580,48746,15779,30078,45857,36834,13.13571335,7.482045838,5.653667509,2.421925928,4.616685978,7.038611906
Arizona,2013,6634999,78370,86100,50590,18681,23960,42641,35510,13.05373378,7.670016165,5.383717612,2.832250879,3.632606984,6.464857863
Arizona,2014,6733840,98841,86124,50236,22020,40464,62484,35888,12.8842901,7.515387088,5.368903014,3.294227719,6.053480037,9.347707755
Arizona,2015,6833596,99756,86765,52850,20235,45315,65550,33915,12.79018379,7.790712998,4.999470792,2.982877531,6.679965175,9.662842707
Arizona,2016,6945452,111856,84965,56023,20865,61949,82814,28942,12.33249206,8.131621285,4.200870771,3.028511113,8.991767791,12.02027891
Arizona,2017,7048876,103424,83743,57680,14248,62930,77178,26063,11.96813452,8.24333973,3.724794788,2.036253545,8.993643711,11.02989726
Arizona,2018,7171646,122770,83550,58806,14335,83240,97575,24744,11.7506235,8.270582472,3.480041028,2.016100394,11.70702454,13.72312493
Arkansas,2010,2921978,5950,9438,6967,811,2459,3270,2471,0,0,0,0,0,0
Arkansas,2011,2940407,18429,38442,29463,3717,5504,9221,8979,13.11479884,10.05154046,3.063258384,1.268084577,1.877734062,3.145818639
Arkansas,2012,2952109,11702,38596,29775,3799,-1099,2700,8821,13.10000686,10.10603959,2.993967263,1.289432222,-0.373015534,0.916416689
Arkansas,2013,2959549,7440,37977,30939,2384,-2046,338,7038,12.84817221,10.4671143,2.381057903,0.806541921,-0.692191598,0.114350323
Arkansas,2014,2967726,8177,38230,29942,3188,-3305,-117,8288,12.89968831,10.10312496,2.796563345,1.075705109,-1.115183621,-0.039478512
Arkansas,2015,2978407,10681,38779,31331,3398,-146,3252,7448,13.04343512,10.53827757,2.505157554,1.142927681,-0.049107546,1.093820135
Arkansas,2016,2990410,12003,38604,31142,3516,1065,4581,7462,12.93522653,10.43489857,2.500327954,1.178122901,0.356854633,1.534977534
Arkansas,2017,3002997,12587,37703,31299,2180,4003,6183,6404,12.58149163,10.44447674,2.13701489,0.727466031,1.335801156,2.063267187
Arkansas,2018,3013825,10828,37191,31093,2260,2475,4735,6098,12.36234012,10.33535644,2.02698368,0.751227143,0.822693442,1.573920585
California,2010,37320903,66380,123311,57268,21145,-20443,702,66043,0,0,0,0,0,0
California,2011,37641823,320920,509763,238444,105527,-53949,51578,271319,13.60043924,6.361668331,7.238770906,2.815452576,-1.43935534,1.376097235
California,2012,37960782,318959,497431,239549,105015,-40787,64228,257882,13.15909683,6.337056772,6.822040061,2.778078877,-1.078983985,1.699094892
California,2013,38280824,320042,499628,247723,123416,-52973,70443,251905,13.10643955,6.498367833,6.608071714,3.237497384,-1.389608713,1.847888671
California,2014,38625139,344315,498911,243951,138111,-45720,92391,254960,12.9745726,6.34413745,6.630435146,3.591685082,-1.188984526,2.402700555
California,2015,38953142,328003,500353,253556,164026,-80259,83767,246797,12.89930619,6.536777993,6.362528193,4.228657761,-2.069110039,2.159547722
California,2016,39209127,255985,490384,259932,148792,-122586,26206,230452,12.54784454,6.651086345,5.896758192,3.807258973,-3.136705256,0.670553717
California,2017,39399349,190222,481969,273362,119732,-137608,-17876,208607,12.26251988,6.955026071,5.307493813,3.046287273,-3.501098279,-0.454811005
California,2018,39557045,157696,477145,280674,117797,-156068,-38271,196471,12.08629158,7.109595203,4.976696378,2.983849541,-3.953270713,-0.969421172
Colorado,2010,5048281,18965,16789,7840,2376,6792,9168,8949,0,0,0,0,0,0
Colorado,2011,5121771,73490,65919,32015,12670,26255,38925,33904,12.96335555,6.295936343,6.667419203,2.491629345,5.163198772,7.654828117
Colorado,2012,5193721,71950,64743,32723,11357,27951,39308,32020,12.55257626,6.344438055,6.208138206,2.201930843,5.419227701,7.621158545
Colorado,2013,5270482,76761,64736,33581,9060,35843,44903,31155,12.37284865,6.418262337,5.954586317,1.731617783,6.850593399,8.582211182
Colorado,2014,5351218,80736,65722,33934,9814,38359,48173,31788,12.37504354,6.389560993,5.98548255,1.847915117,7.222760952,9.070676069
Colorado,2015,5452107,100889,66345,36264,13493,56508,70001,30081,12.28232975,6.713488671,5.568841074,2.497934664,10.46122374,12.95915841
Colorado,2016,5540921,88814,66595,36727,9546,49138,58684,29868,12.11586107,6.681871455,5.433989616,1.736737139,8.939848056,10.6765852
Colorado,2017,5615902,74981,66373,37688,8447,37643,46090,28685,11.89819001,6.756045157,5.142144856,1.51423035,6.747978345,8.262208695
Colorado,2018,5695564,79662,66249,38367,8207,43293,51500,27882,11.71360105,6.783736078,4.929864971,1.451093961,7.654710716,9.105804676
Connecticut,2010,3579125,4978,9492,6843,2452,124,2576,2649,0,0,0,0,0,0
Connecticut,2011,3588023,8898,37642,29315,13027,-12343,684,8327,10.50403871,8.180380815,2.32365789,3.63519771,-3.444326809,0.190870902
Connecticut,2012,3594395,6372,36853,29087,16035,-17392,-1357,7766,10.26200369,8.099500753,2.162502934,4.46507012,-4.842937295,-0.377867175
Connecticut,2013,3594915,520,36138,29784,11171,-16929,-5758,6354,10.05325963,8.2856352,1.767624431,3.107669582,-4.709492288,-1.601822706
Connecticut,2014,3594783,-132,36158,29668,18263,-25041,-6778,6490,10.05828061,8.252919664,1.805360948,5.080324653,-6.965800232,-1.885475579
Connecticut,2015,3587509,-7274,36319,30373,16614,-29986,-13372,5946,10.11348467,8.4577458,1.655738864,4.626378321,-8.349980758,-3.723602438
Connecticut,2016,3578674,-8835,35892,30085,14489,-29202,-14713,5807,10.01704813,8.396380612,1.620667516,4.043714764,-8.149945375,-4.106230611
Connecticut,2017,3573880,-4794,35396,31069,14454,-23652,-9198,4327,9.897443626,8.687526162,1.209917464,4.04163324,-6.613581666,-2.571948426
Connecticut,2018,3572665,-1215,35048,31312,16494,-21509,-5015,3736,9.808375936,8.762835748,1.045540188,4.615936792,-6.019412177,-1.403475386
Delaware,2010,899595,1661,2848,1842,362,276,638,1006,0,0,0,0,0,0
Delaware,2011,907316,7721,11301,7872,1556,2782,4338,3429,12.50864044,8.71321277,3.795427666,1.722276305,3.079288355,4.801564659
Delaware,2012,915188,7872,11155,7693,1244,3231,4475,3462,12.24139975,8.442231128,3.799168616,1.365154754,3.54567123,4.910825985
Delaware,2013,923638,8450,10889,8092,2387,3322,5709,2797,11.84342619,8.801267765,3.042158421,2.59622172,3.613174928,6.209396648
Delaware,2014,932596,8958,10982,8077,1781,4246,6027,2905,11.8325599,8.702566595,3.129993309,1.918939099,4.574854248,6.493793347
Delaware,2015,941413,8817,11026,8533,2281,4049,6330,2493,11.76728607,9.106679851,2.660606219,2.434353304,4.321217241,6.755570544
Delaware,2016,949216,7803,11086,8503,1838,3377,5215,2583,11.72731403,8.99489006,2.732423971,1.944326465,3.572356078,5.516682543
Delaware,2017,957078,7862,10868,9189,1688,4470,6158,1679,11.40222862,9.640695507,1.761533111,1.770975516,4.689727817,6.460703333
Delaware,2018,967171,10093,10709,9307,1820,6858,8678,1402,11.13057614,9.673384266,1.457191871,1.891647079,7.127975641,9.01962272
District of Columbia,2010,605085,3319,2246,1180,699,1343,2042,1066,0,0,0,0,0,0
District of Columbia,2011,619602,14517,9199,4672,2429,7251,9680,4527,15.02261394,7.629704569,7.392909372,3.966727825,11.84139294,15.80812077
District of Columbia,2012,634725,15123,9231,4543,3410,6760,10170,4688,14.71864992,7.243725121,7.4749248,5.437178662,10.77868849,16.21586715
District of Columbia,2013,650431,15706,9446,4811,4751,6118,10869,4635,14.70016091,7.487028812,7.213132102,7.393654934,9.521023129,16.91467806
District of Columbia,2014,662513,12082,9334,4648,5222,2086,7308,4686,14.2184282,7.080271512,7.138156692,7.954642392,3.177591733,11.13223412
District of Columbia,2015,675254,12741,9652,4895,5042,2865,7907,4757,14.43001659,7.318165271,7.111851316,7.537934483,4.283257099,11.82119158
District of Columbia,2016,686575,11321,9715,4855,3504,2907,6411,4860,14.26757691,7.130116924,7.13745999,5.146020536,4.269258475,9.415279011
District of Columbia,2017,695691,9116,9780,5452,3616,1146,4762,4328,14.15067722,7.888496136,6.262181085,5.231988633,1.65814684,6.890135473
District of Columbia,2018,702455,6764,9788,5684,3592,-936,2656,4104,14.001399,8.130767459,5.870631536,5.13823306,-1.338915964,3.799317096
Florida,2010,18845785,41205,50875,41767,22421,10291,32712,9108,0,0,0,0,0,0
Florida,2011,19093352,247567,213213,174508,101645,106023,207668,38705,11.23973906,9.199365816,2.040373243,5.358319036,5.589109737,10.94742877
Florida,2012,19326230,232878,214009,173749,99907,91420,191327,40260,11.14062095,9.044814699,2.095806248,5.200837427,4.759031475,9.959868902
Florida,2013,19563166,236936,212995,181628,104788,99974,204762,31367,10.95388573,9.340746768,1.613138965,5.38902687,5.141452956,10.53047983
Florida,2014,19860330,297164,218336,181057,113737,143628,257365,37279,11.0764403,9.18523309,1.891207213,5.770010859,7.286416202,13.05642706
Florida,2015,20224249,363919,221755,190991,134214,196632,330846,30764,11.0643547,9.529400321,1.534954377,6.696540333,9.810855192,16.50739553
Florida,2016,20629982,405733,224643,193629,157738,216222,373960,31014,10.99729426,9.47901822,1.518276039,7.7219909,10.5850481,18.30703899
Florida,2017,20976812,346830,224012,203723,162228,163595,325823,20289,10.76804908,9.79277567,0.975273413,7.798149504,7.863859926,15.66200943
Florida,2018,21299325,322513,221488,208165,175670,132602,308272,13323,10.47815698,9.847872335,0.630284645,8.310598483,6.273137018,14.5837355
Georgia,2010,9711810,23101,32497,17199,4174,2883,7057,15298,0,0,0,0,0,0
Georgia,2011,9801578,89768,132614,71126,11982,15503,27485,61488,13.59210405,7.289969328,6.302134719,1.228079921,1.588960359,2.81704028
Georgia,2012,9901496,99918,131870,70422,21860,15704,37564,61448,13.38572854,7.148326195,6.237402347,2.218943095,1.594065982,3.813009077
Georgia,2013,9973326,71830,128660,74815,22766,-5471,17295,53845,12.94703419,7.528620885,5.418413307,2.290938757,-0.550545811,1.740392945
Georgia,2014,10069001,95675,129559,74830,17314,23419,40733,54729,12.92853869,7.467196798,5.461341889,1.72774349,2.336954187,4.064697677
Georgia,2015,10181111,112110,131677,78528,25712,33086,58798,53149,13.00506387,7.755808956,5.249254918,2.539442745,3.267735013,5.807177758
Georgia,2016,10304763,123652,130724,80016,34971,37979,72950,50708,12.76235517,7.811821941,4.950533231,3.414157482,3.707823254,7.121980737
Georgia,2017,10413055,108292,129047,82779,21625,40388,62013,46268,12.45758603,7.991092498,4.466493528,2.087575053,3.898866184,5.986441236
Georgia,2018,10519475,106420,127649,84888,21786,41914,63700,42761,12.19623237,8.110629723,4.085602648,2.081544849,4.004675976,6.086220825
Hawaii,2010,1363963,3656,4644,2534,1988,-359,1629,2110,0,0,0,0,0,0
Hawaii,2011,1379252,15289,19154,10064,7313,-938,6375,9090,13.96463639,7.337376035,6.62726035,5.331700213,-0.68386911,4.647831103
Hawaii,2012,1394905,15653,18896,10245,10197,-3013,7184,8651,13.62287715,7.386027539,6.236849609,7.351422432,-2.172191408,5.179231024
Hawaii,2013,1408453,13548,19036,10339,5758,-760,4998,8697,13.58085553,7.376153884,6.204701647,4.10793056,-0.542206882,3.565723679
Hawaii,2014,1414862,6409,18955,10739,3940,-5688,-1748,8216,13.42747798,7.607369351,5.820108631,2.791045278,-4.029305975,-1.238260697
Hawaii,2015,1422484,7622,18215,11069,7389,-6834,555,7146,12.83946336,7.802361785,5.037101573,5.208388402,-4.817177743,0.39121066
Hawaii,2016,1428105,5621,18249,10838,9669,-11424,-1755,7411,12.8036697,7.604042533,5.199627165,6.78386116,-8.015185634,-1.231324474
Hawaii,2017,1424203,-3902,17817,12275,4721,-14153,-9432,5542,12.49304072,8.607064875,3.885975848,3.310301693,-9.923893212,-6.61359152
Hawaii,2018,1420491,-3712,17326,12660,4075,-12430,-8355,4666,12.18127503,8.900781596,3.280493438,2.864983018,-8.739077033,-5.874094015
Idaho,2010,1570773,3116,5969,2558,122,-378,-256,3411,0,0,0,0,0,0
Idaho,2011,1583828,13055,22952,11887,1608,272,1880,11065,14.55144407,7.536293813,7.015150252,1.019463317,0.172446531,1.191909849
Idaho,2012,1595441,11613,22362,11899,1593,-558,1035,10463,14.06738467,7.485368492,6.58201618,1.002117153,-0.351024088,0.651093066
Idaho,2013,1611530,16089,22704,12298,1855,3695,5550,10406,14.15915517,7.669542381,6.489612784,1.156854864,2.304355106,3.46120997
Idaho,2014,1631479,19949,22434,12543,1403,8462,9865,9891,13.83529925,7.73540869,6.099890565,0.865245826,5.218610248,6.083856073
Idaho,2015,1651523,20044,23036,12894,3101,6752,9853,10142,14.03349739,7.855005876,6.178491515,1.889124649,4.11330849,6.002433139
Idaho,2016,1682930,31407,22649,13287,3505,18493,21998,9362,13.58483685,7.969523037,5.615313816,2.10229384,11.09207417,13.19436801
Idaho,2017,1718904,35974,22403,12909,1694,24732,26426,9494,13.17113063,7.589435581,5.58169505,0.99593337,14.54039204,15.53632541
Idaho,2018,1754208,35304,22412,12989,1681,24095,25776,9423,12.90600476,7.47974727,5.426257489,0.968007942,13.87516441,14.84317235
Illinois,2010,12840762,9190,41835,24054,5136,-13357,-8221,17781,0,0,0,0,0,0
Illinois,2011,12867291,26529,162426,101615,31610,-65999,-34389,60811,12.63619614,7.905305003,4.730891134,2.459151613,-5.134500073,-2.67534846
Illinois,2012,12884119,16828,160152,101291,28316,-70308,-41992,58861,12.4383092,7.86683137,4.571477834,2.19918055,-5.460516531,-3.261335981
Illinois,2013,12898269,14150,157511,104307,28700,-67632,-38932,53204,12.21849582,8.091337389,4.127158431,2.226325971,-5.246372058,-3.020046087
Illinois,2014,12888962,-9307,157522,102709,29935,-94459,-64524,54813,12.21705425,7.965880478,4.251173769,2.321691693,-7.326028917,-5.004337224
Illinois,2015,12864342,-24620,159244,107598,31480,-108103,-76623,51646,12.36687922,8.356054043,4.010825174,2.444734858,-8.395272311,-5.950537453
Illinois,2016,12826895,-37447,156299,106197,25446,-113136,-87690,50102,12.16749509,8.267176859,3.900318229,1.980908899,-8.807361047,-6.826452148
Illinois,2017,12786196,-40699,151472,108248,30536,-114689,-84153,43224,11.8277017,8.452552642,3.37514906,2.384405693,-8.955498577,-6.571092884
Illinois,2018,12741080,-45116,148117,110092,30735,-114154,-83419,38025,11.60460677,8.62544049,2.979166285,2.408012512,-8.943688312,-6.5356758
Indiana,2010,6490436,6375,20960,13860,2391,-3061,-670,7100,0,0,0,0,0,0
Indiana,2011,6516045,25609,83465,57898,8941,-8711,230,25567,12.8343708,8.902946154,3.931424649,1.374853044,-1.339486061,0.035366984
Indiana,2012,6537640,21595,83077,58627,10680,-13318,-2638,24450,12.72851306,8.982444421,3.746068639,1.636319553,-2.040496611,-0.404177058
Indiana,2013,6568367,30727,83369,60708,8760,-382,8378,22661,12.72225782,9.264148875,3.458108942,1.336791595,-0.05829388,1.278497715
Indiana,2014,6593533,25166,83522,59856,9708,-7613,2095,23666,12.69148071,9.095343378,3.596137336,1.475166959,-1.156823863,0.318343096
Indiana,2015,6608296,14763,84172,62946,8007,-14132,-6125,21226,12.75156647,9.53595142,3.215615049,1.213013742,-2.140915475,-0.927901732
Indiana,2016,6633344,25048,83560,62143,13506,-9743,3763,21417,12.6207932,9.385997505,3.23479569,2.039928589,-1.471569987,0.568358602
Indiana,2017,6660082,26738,82093,62611,9067,-1639,7428,19482,12.35091691,9.419844064,2.931072848,1.364132918,-0.24658805,1.117544868
Indiana,2018,6691878,31796,81075,61864,9227,3555,12782,19211,12.14428444,9.266654484,2.877629951,1.38211918,0.532506089,1.914625269
Iowa,2010,3050767,3895,9966,6871,1454,-553,901,3095,0,0,0,0,0,0
Iowa,2011,3066054,15287,37852,28210,6180,-541,5639,9642,12.37636347,9.223745472,3.152618002,2.020657462,-0.17688927,1.843768193
Iowa,2012,3076097,10043,38478,28048,4068,-4438,-370,10430,12.5291612,9.132956842,3.396204359,1.324617386,-1.445096351,-0.120478966
Iowa,2013,3093078,16981,38805,29139,6973,306,7279,9666,12.58028829,9.446644,3.133644288,2.260594002,0.099202892,2.359796893
Iowa,2014,3109504,16426,39460,28925,6862,-891,5971,10535,12.72373344,9.326761017,3.396972422,2.212626935,-0.287299708,1.925327227
Iowa,2015,3121460,11956,39694,29808,5492,-3304,2188,9886,12.74088568,9.567700921,3.173184759,1.762809093,-1.060510059,0.702299034
Iowa,2016,3131785,10325,39428,29189,5622,-5508,114,10239,12.61041267,9.335632939,3.274779734,1.798106423,-1.761645354,0.036461069
Iowa,2017,3143637,11852,38892,28817,5809,-4010,1799,10075,12.395023,9.184083557,3.21093944,1.851349599,-1.278001703,0.573347896
Iowa,2018,3156145,12508,38417,28803,5828,-2886,2942,9614,12.19629505,9.14412594,3.052169107,1.850222754,-0.91622218,0.934000573
Kansas,2010,2858213,5087,9990,5994,946,210,1156,3996,0,0,0,0,0,0
Kansas,2011,2869035,10822,40125,25179,4854,-8983,-4129,14946,14.01196526,8.792704629,5.219260629,1.695054937,-3.136934179,-1.441879241
Kansas,2012,2885361,16326,39580,24967,6097,-4459,1638,14613,13.75643943,8.677539745,5.07889968,2.119075573,-1.549771688,0.569303885
Kansas,2013,2893510,8149,39724,25593,5815,-11799,-5984,14131,13.7480141,8.857439455,4.890574647,2.012503826,-4.083496586,-2.07099276
Kansas,2014,2900896,7386,39291,25500,6641,-13033,-6392,13791,13.56170072,8.801592432,4.760108284,2.292210798,-4.498476634,-2.206265836
Kansas,2015,2909502,8606,38999,26557,9214,-12945,-3731,12442,13.42386528,9.141198245,4.282667039,3.171555546,-4.455804921,-1.284249375
Kansas,2016,2911263,1761,38616,26270,7582,-18147,-10565,12346,13.26835906,9.026304962,4.242054094,2.605155852,-6.235262891,-3.630107039
Kansas,2017,2910689,-574,37410,25477,2267,-14741,-12474,11933,12.85135982,8.752047423,4.099312396,0.778776603,-5.063937319,-4.285160716
Kansas,2018,2911505,816,36637,25272,2057,-12564,-10507,11365,12.58529001,8.681263455,3.904026558,0.706606479,-4.315898783,-3.609292305
Kentucky,2010,4348200,8867,13696,10539,1512,4035,5547,3157,0,0,0,0,0,0
Kentucky,2011,4369488,21288,55319,42430,5057,3434,8491,12889,12.69120895,9.734232287,2.956976666,1.16016999,0.787823561,1.947993551
Kentucky,2012,4386381,16893,55290,42787,7841,-3330,4511,12503,12.62924331,9.773330323,2.855912988,1.791027253,-0.760632668,1.030394585
Kentucky,2013,4404817,18436,56047,44424,8887,-2018,6869,11623,12.75070815,10.10647241,2.644235746,2.021794982,-0.459095564,1.562699418
Kentucky,2014,4414483,9666,55757,43684,5034,-7165,-2131,12073,12.64431418,9.906455161,2.737859014,1.141587201,-1.624845509,-0.483258308
Kentucky,2015,4425999,11516,55948,46367,7459,-5351,2108,9581,12.65722842,10.48969954,2.167528875,1.687464552,-1.210567478,0.476897074
Kentucky,2016,4438229,12230,55666,46758,7104,-3670,3434,8908,12.55969499,10.54981889,2.0098761,1.602846858,-0.828047293,0.774799565
Kentucky,2017,4453874,15645,54793,46577,5923,1627,7550,8216,12.32396881,10.476037,1.847931811,1.332193296,0.36594268,1.698135975
Kentucky,2018,4468402,14528,53803,45778,5816,798,6614,8025,12.06037563,10.26150727,1.798868361,1.303703226,0.178878125,1.48258135
Louisiana,2010,4544532,11047,14574,9177,1206,4091,5297,5397,0,0,0,0,0,0
Louisiana,2011,4575184,30652,62300,40758,6783,1970,8753,21542,13.66270616,8.938436241,4.724269922,1.487546323,0.432030998,1.91957732
Louisiana,2012,4600814,25630,62274,40737,4209,-304,3905,21537,13.57323748,8.879034193,4.69420329,0.9173934,-0.066259823,0.851133577
Louisiana,2013,4624577,23763,62527,43780,6178,-1426,4752,18747,13.55541462,9.491196633,4.064217983,1.339347026,-0.309146788,1.030200238
Louisiana,2014,4644204,19627,64205,43574,4690,-5676,-986,20631,13.85403323,9.402315148,4.451718085,1.011999313,-1.224756524,-0.212757212
Louisiana,2015,4664851,20647,64393,43957,6170,-5903,267,20436,13.83448696,9.443923148,4.390563811,1.325591051,-1.268227548,0.057363503
Louisiana,2016,4678215,13364,63973,43673,6247,-13106,-6859,20300,13.69421986,9.348751256,4.345468607,1.337248394,-2.805503033,-1.468254639
Louisiana,2017,4670818,-7397,62145,45145,3064,-27458,-24394,17000,13.29442307,9.657683313,3.636739757,0.65546886,-5.873976485,-5.218507625
Louisiana,2018,4659978,-10840,60341,46256,3012,-27914,-24902,14085,12.93373041,9.914695381,3.019035032,0.645604084,-5.983198004,-5.33759392
Maine,2010,1327632,-737,3439,3099,294,-1313,-1019,340,0,0,0,0,0,0
Maine,2011,1328150,518,12625,13029,1110,-82,1028,-404,9.507557473,9.811799312,-0.304241839,0.835911984,-0.061752056,0.774159927
Maine,2012,1327691,-459,12803,12749,492,-841,-349,54,9.64139043,9.600725345,0.040665085,0.370504108,-0.633321046,-0.262816938
Maine,2013,1328196,505,12871,13403,1753,-594,1159,-532,9.692430439,10.09304989,-0.400619454,1.320086284,-0.447308187,0.872778096
Maine,2014,1330760,2564,12700,13354,3002,364,3366,-654,9.552621405,10.0445438,-0.491922394,2.258029091,0.273791669,2.53182076
Maine,2015,1328484,-2276,12652,14178,621,-1270,-649,-1526,9.515486356,10.66318096,-1.147694608,0.467050034,-0.955158684,-0.48810865
Maine,2016,1331370,2886,12652,14169,1922,2536,4458,-1517,9.513304114,10.65396823,-1.140664112,1.445192105,1.90687158,3.352063685
Maine,2017,1335063,3693,12581,14113,579,4690,5269,-1532,9.43657688,10.58567757,-1.14910069,0.434288055,3.517808248,3.952096302
Maine,2018,1338404,3341,12438,14079,570,4469,5039,-1641,9.304771669,10.53239109,-1.227619417,0.426412595,3.34322436,3.769636955
Maryland,2010,5788642,14844,18454,10628,6590,841,7431,7826,0,0,0,0,0,0
Maryland,2011,5838991,50349,73542,43674,20726,208,20934,29868,12.64952205,7.512105,5.137417048,3.564955998,0.035776843,3.600732841
Maryland,2012,5887072,48081,72720,43461,25760,-6323,19437,29259,12.40313991,7.412718148,4.990421764,4.39363152,-1.078452333,3.315179187
Maryland,2013,5923704,36632,72362,45736,21406,-10919,10487,26626,12.25355557,7.744791706,4.508763861,3.624825329,-1.848989431,1.775835898
Maryland,2014,5958165,34461,72756,44735,23397,-16504,6893,28021,12.24655818,7.529960144,4.716598037,3.938269308,-2.778014132,1.160255175
Maryland,2015,5986717,28552,74158,47160,27566,-25680,1886,26998,12.41669863,7.896268879,4.520429754,4.615533247,-4.299749466,0.315783781
Maryland,2016,6004692,17975,73387,47239,21569,-29676,-8107,26148,12.23992944,7.878807236,4.3611222,3.597408778,-4.949543461,-1.352134682
Maryland,2017,6024891,20199,72138,50555,22756,-24011,-1255,21583,11.99343319,8.405112629,3.588320559,3.783339788,-3.991992075,-0.208652287
Maryland,2018,6042718,17827,71029,51184,22575,-24518,-1943,19845,11.77184312,8.482873451,3.288969671,3.741420525,-4.063439576,-0.322019051
Massachusetts,2010,6566431,18641,18647,12289,8978,3556,12534,6358,0,0,0,0,0,0
Massachusetts,2011,6613149,46718,73183,54019,33969,-5779,28190,19164,11.10551323,8.197378065,2.908135161,5.15479249,-0.876962695,4.277829794
Massachusetts,2012,6663158,50009,72220,52417,38501,-7578,30923,19803,10.87953148,7.896322373,2.983209111,5.799956268,-1.14158252,4.658373748
Massachusetts,2013,6713944,50786,72154,54785,37172,-3050,34122,17369,10.7876878,8.190862266,2.596825531,5.557556487,-0.456003101,5.101553386
Massachusetts,2014,6763652,49708,71948,54728,44209,-10714,33495,17220,10.67668151,8.12132965,2.55535186,6.560368778,-1.589897783,4.970470995
Massachusetts,2015,6795891,32239,71924,57476,40527,-22191,18336,14448,10.60861712,8.477571847,2.131045272,5.977635087,-3.27311916,2.704515927
Massachusetts,2016,6826022,30131,71418,55962,45032,-30232,14800,15456,10.48575189,8.2164671,2.269284791,6.61169984,-4.438730449,2.172969391
Massachusetts,2017,6863246,37224,70675,58097,49668,-24844,24824,12578,10.32560689,8.48796298,1.837643912,7.256487345,-3.629704671,3.626782674
Massachusetts,2018,6902149,38903,70297,58506,53013,-25755,27258,11791,10.21358268,8.500446228,1.713136456,7.702357978,-3.741992148,3.96036583
Michigan,2010,9877535,-6582,29109,22099,4618,-18683,-14065,7010,0,0,0,0,0,0
Michigan,2011,9881521,3986,113976,89842,21780,-42146,-20366,24134,11.53658353,9.093754277,2.442829253,2.20455876,-4.265993274,-2.061434514
Michigan,2012,9896930,15409,113078,89049,24111,-32516,-8405,24029,11.43446471,9.004648544,2.429816167,2.43810802,-3.288022909,-0.84991489
Michigan,2013,9913349,16419,113008,92298,23401,-27887,-4486,20710,11.4090266,9.318192843,2.090833754,2.362510897,-2.815407092,-0.452896196
Michigan,2014,9930589,17240,114523,91829,23342,-28283,-4941,22694,11.54236624,9.255118616,2.287247622,2.352557239,-2.850543073,-0.497985833
Michigan,2015,9932573,1984,113793,96368,21492,-36454,-14962,17425,11.45769239,9.703188244,1.754504142,2.164005912,-3.670513285,-1.506507373
Michigan,2016,9951890,19317,113315,94775,28090,-27061,1029,18540,11.39734073,9.532568217,1.864772511,2.825321458,-2.721823566,0.103497892
Michigan,2017,9976447,24557,112080,95630,21416,-13021,8395,16450,11.24830436,9.597388884,1.650915478,2.149301269,-1.306782397,0.842518872
Michigan,2018,9995915,19468,110676,95614,21415,-16766,4649,15062,11.08291548,9.574631183,1.508284298,2.144463434,-1.6789201,0.465543334
Minnesota,2010,5310843,6918,17498,9340,2954,-4049,-1095,8158,0,0,0,0,0,0
Minnesota,2011,5345668,34825,68368,39982,11931,-5302,6629,28386,12.83121652,7.503769292,5.327447229,2.239194423,-0.995072402,1.244122021
Minnesota,2012,5376550,30882,68045,39316,11342,-8917,2425,28729,12.6923366,7.333557292,5.358779312,2.115607051,-1.663275266,0.452331784
Minnesota,2013,5413693,37143,68968,41320,11130,-1281,9849,27648,12.78340071,7.658770984,5.124629723,2.062974856,-0.237436729,1.825538127
Minnesota,2014,5451522,37829,69895,40824,16024,-6649,9375,29071,12.86582916,7.514623503,5.35120566,2.949596488,-1.223905832,1.725690656
Minnesota,2015,5482503,30981,69709,42943,16573,-11896,4677,26766,12.7508397,7.854929909,4.895909786,3.031454565,-2.175959905,0.85549466
Minnesota,2016,5523409,40906,69813,42664,16392,-2432,13960,27149,12.68645434,7.752924065,4.93353027,2.978762687,-0.441944293,2.536818394
Minnesota,2017,5568155,44746,69258,42646,10766,7598,18364,26612,12.48841011,7.689808218,4.798601892,1.941295204,1.370050247,3.311345451
Minnesota,2018,5611179,43024,68617,42847,10718,6769,17487,25770,12.27568655,7.665394021,4.610292527,1.91746664,1.210984483,3.128451122
Mississippi,2010,2970536,2418,9418,6643,594,-1077,-483,2775,0,0,0,0,0,0
Mississippi,2011,2978470,7934,39745,29131,2117,-5002,-2885,10614,13.36189609,9.793568875,3.568327213,0.711715537,-1.681625468,-0.969909931
Mississippi,2012,2983767,5297,39431,29018,1993,-7351,-5358,10413,13.22691466,9.733930402,3.492984261,0.668541019,-2.465853001,-1.797311982
Mississippi,2013,2988797,5030,38506,30639,1737,-4638,-2901,7867,12.89429465,10.25991517,2.634379473,0.581659736,-1.553101817,-0.971442081
Mississippi,2014,2990623,1826,38716,30579,2608,-8933,-6325,8137,12.94975098,10.22808232,2.721668657,0.87232541,-2.987915216,-2.115589806
Mississippi,2015,2988693,-1930,38578,31507,3243,-12263,-9020,7071,12.90381709,10.53866362,2.365153472,1.084739459,-4.101806963,-3.017067504
Mississippi,2016,2988298,-395,38155,31500,961,-7990,-7029,6655,12.76729378,10.54042076,2.22687302,0.321566487,-2.67358609,-2.352019603
Mississippi,2017,2989663,1365,37204,31081,2612,-7367,-4755,6123,12.44705344,10.39852886,2.048524572,0.873876561,-2.464719994,-1.590843433
Mississippi,2018,2986530,-3133,36319,31356,2749,-10818,-8069,4963,12.1545606,10.493637,1.660923601,0.919983675,-3.620365005,-2.70038133
Missouri,2010,5995976,7024,19015,13181,1884,-516,1368,5834,0,0,0,0,0,0
Missouri,2011,6009641,13665,76247,55984,8457,-14935,-6478,20263,12.70188779,9.326301181,3.375586611,1.408840545,-2.488002074,-1.079161529
Missouri,2012,6024081,14440,75430,55633,6545,-11587,-5042,19797,12.53643719,9.24618335,3.290253838,1.0877765,-1.925754974,-0.837978474
Missouri,2013,6040658,16577,75170,57580,5486,-6235,-749,17590,12.4611067,9.545171263,2.915935438,0.90942705,-1.033590532,-0.124163482
Missouri,2014,6056293,15635,75777,57133,6303,-8922,-2619,18644,12.52828089,9.445851273,3.082429614,1.042080769,-1.47508244,-0.433001671
Missouri,2015,6071745,15452,75141,60058,9122,-8381,741,15083,12.39128703,9.903992715,2.487294318,1.504282886,-1.382086699,0.122196187
Missouri,2016,6087203,15458,74889,59239,5634,-5749,-115,15650,12.31833544,9.744099572,2.574235863,0.926724911,-0.945641021,-0.01891611
Missouri,2017,6108612,21409,73617,59411,8169,-893,7276,14206,12.07250192,9.742850314,2.329651606,1.339639868,-0.146443678,1.193196191
Missouri,2018,6126452,17840,72508,59825,8077,-2790,5287,12683,11.85249215,9.779270464,2.073221685,1.320303678,-0.45606627,0.864237408
Montana,2010,990722,1313,3067,2387,346,303,649,680,0,0,0,0,0,0
Montana,2011,997221,6499,12005,9128,437,3177,3614,2877,12.07781108,9.183361897,2.894449187,0.439650433,3.196268706,3.635919139
Montana,2012,1003754,6533,12035,8958,332,3090,3422,3077,12.0291358,8.953635103,3.075500693,0.331838229,3.088494359,3.420332588
Montana,2013,1013564,9810,12205,9444,1654,5359,7013,2761,12.10022416,9.36292642,2.737297739,1.639800964,5.312994778,6.952795742
Montana,2014,1021891,8327,12386,9381,618,4648,5266,3005,12.17025186,9.217595083,2.952656777,0.607235237,4.567037837,5.174273074
Montana,2015,1030503,8612,12578,9686,595,5070,5665,2892,12.25690584,9.438733499,2.818172339,0.579810699,4.94057184,5.520382539
Montana,2016,1040863,10360,12425,9926,837,7010,7847,2499,11.99691411,9.584013641,2.412900472,0.808162343,6.768480317,7.57664266
Montana,2017,1053090,12227,12182,9641,932,8708,9640,2541,11.6354092,9.208420628,2.426988571,0.890182349,8.317283148,9.207465497
Montana,2018,1062305,9215,12050,9726,889,5987,6876,2324,11.39267135,9.195445768,2.197225577,0.840504965,5.660408576,6.500913541
Nebraska,2010,1829536,3231,6512,3657,657,-251,406,2855,0,0,0,0,0,0
Nebraska,2011,1840538,11002,25725,15622,2131,-1209,922,10103,14.0187909,8.513179843,5.505611059,1.161284486,-0.658842301,0.502442185
Nebraska,2012,1853323,12785,25762,15218,3249,-930,2319,10544,13.94854869,8.239617029,5.708931657,1.759134954,-0.503538168,1.255596786
Nebraska,2013,1865414,12091,26022,16171,3146,-839,2307,9851,13.99507413,8.697038807,5.298035328,1.691972301,-0.451228468,1.240743833
Nebraska,2014,1879522,14108,26468,15706,5065,-1635,3430,10762,14.13535505,8.3878603,5.74749475,2.704986147,-0.873179141,1.831807006
Nebraska,2015,1891507,11985,26859,16577,4112,-2311,1801,10282,14.2449183,8.791764794,5.453153503,2.180837114,-1.225660158,0.955176956
Nebraska,2016,1905924,14417,26632,16167,5958,-1959,3999,10465,14.02632464,8.514703756,5.511620883,3.137910867,-1.031750149,2.106160718
Nebraska,2017,1917575,11651,26169,15650,4742,-3550,1192,10519,13.68850888,8.186218958,5.502289918,2.480450498,-1.856937847,0.623512652
Nebraska,2018,1929268,11693,25899,15565,4705,-3314,1391,10334,13.46506733,8.092350013,5.372717317,2.446161697,-1.722971278,0.723190419
Nevada,2010,2702464,1785,8892,4947,985,-3055,-2070,3945,0,0,0,0,0,0
Nevada,2011,2712799,10335,35846,20201,1107,-6189,-5082,15645,13.23887686,7.46076414,5.778112716,0.408844409,-2.28576156,-1.876917151
Nevada,2012,2744566,31767,34702,20405,3710,13595,17305,14297,12.71749278,7.477967847,5.239524936,1.359630518,4.982257921,6.341888439
Nevada,2013,2776972,32406,35089,21253,4574,13984,18558,13836,12.70986453,7.698217417,5.011647117,1.656784758,5.065255369,6.722040127
Nevada,2014,2819012,42040,35226,21271,3914,23822,27736,13955,12.58974293,7.602237605,4.987505325,1.398860326,8.513962871,9.912823196
Nevada,2015,2868666,49654,36231,22465,6566,29019,35585,13766,12.7401727,7.89953299,4.840639713,2.308850818,10.20416416,12.51301498
Nevada,2016,2919772,51106,36281,23328,3046,34985,38031,12953,12.53567888,8.060205534,4.475473349,1.052442818,12.08788969,13.1403325
Nevada,2017,2972405,52633,36196,24691,3101,37844,40945,11505,12.28612107,8.380943071,3.905178001,1.052582093,12.84550685,13.89808894
Nevada,2018,3034392,61987,36042,25041,3100,47596,50696,11001,12.00040554,8.33755494,3.662850601,1.032164064,15.84738089,16.87954496
New Hampshire,2010,1316777,313,3265,2518,448,-807,-359,747,0,0,0,0,0,0
New Hampshire,2011,1319815,3038,12993,10736,2908,-2051,857,2257,9.855904895,8.143846299,1.712058597,2.205877891,-1.55579627,0.650081621
New Hampshire,2012,1323962,4147,12370,10507,3261,-847,2414,1863,9.357824053,7.948476744,1.409347309,2.466925161,-0.640749957,1.826175203
New Hampshire,2013,1326408,2446,12595,10872,2548,-1717,831,1723,9.504333357,8.204137536,1.300195822,1.922750408,-1.295668152,0.627082256
New Hampshire,2014,1333223,6815,12222,11097,2835,2949,5784,1125,9.190748641,8.344766624,0.845982018,2.131874685,2.217600863,4.349475548
New Hampshire,2015,1336294,3071,12380,11921,3900,-1153,2747,459,9.275086092,8.93120366,0.343882433,2.921876879,-0.863826677,2.058050202
New Hampshire,2016,1342373,6079,12358,11820,3815,1775,5590,538,9.226977448,8.825285114,0.401692334,2.848431701,1.325286047,4.173717748
New Hampshire,2017,1349767,7394,12222,12073,2548,4738,7286,149,9.07976554,8.969072931,0.110692609,1.892917902,3.519876381,5.412794283
New Hampshire,2018,1356458,6691,12149,11935,2606,3928,6534,214,8.978558693,8.820404807,0.158153886,1.925930032,2.902936748,4.828866779
New Jersey,2010,8799624,7662,26538,17091,7198,-8758,-1560,9447,0,0,0,0,0,0
New Jersey,2011,8827783,28159,106678,71068,34663,-42169,-7506,35610,12.103652,8.06335271,4.040299291,3.932852972,-4.784481348,-0.851628376
New Jersey,2012,8845483,17700,104520,69049,28184,-45823,-17639,35471,11.8280345,7.813949046,4.014085455,3.189450099,-5.185572378,-1.996122279
New Jersey,2013,8858362,12879,103459,72472,29049,-47133,-18084,30987,11.68774354,8.187148046,3.500595492,3.281660001,-5.324606039,-2.042946038
New Jersey,2014,8866780,8418,103327,70489,30474,-55036,-24562,32838,11.65880646,7.953561106,3.705245352,3.438505598,-6.209936146,-2.771430548
New Jersey,2015,8870869,4089,103119,72485,41745,-68471,-26726,30634,11.62713277,8.173010978,3.454121795,4.706937205,-7.720414357,-3.013477152
New Jersey,2016,8874516,3647,102901,71146,39398,-67589,-28191,31755,11.59749422,8.018535524,3.578958698,4.440365763,-7.617642559,-3.177276796
New Jersey,2017,8888543,14027,101439,75544,45151,-57040,-11889,25895,11.42134359,8.50574217,2.915601418,5.083696451,-6.422317237,-1.338620786
New Jersey,2018,8908520,19977,100226,76370,46660,-50591,-3931,23856,11.26320674,8.582314958,2.680891785,5.243561817,-5.6853201,-0.441758283
New Mexico,2010,2064588,5408,6646,3808,425,2059,2484,2838,0,0,0,0,0,0
New Mexico,2011,2080395,15807,27800,16379,4142,283,4425,11421,13.41380652,7.903048095,5.510758428,1.99856067,0.13655062,2.13511129
New Mexico,2012,2087549,7154,27048,16456,3830,-7179,-3349,10592,12.97906114,7.896459261,5.082601878,1.837836593,-3.444863943,-1.60702735
New Mexico,2013,2092792,5243,26731,16801,5755,-10494,-4739,9930,12.78890885,8.038100241,4.750808606,2.7533639,-5.020643053,-2.267279153
New Mexico,2014,2090342,-2450,26367,17135,1983,-13733,-11750,9232,12.60633774,8.192422237,4.4139155,0.948092985,-6.56589055,-5.617797565
New Mexico,2015,2090211,-131,26051,17653,3933,-12446,-8513,8398,12.4629445,8.445294199,4.017650297,1.881569257,-5.954236198,-4.072666941
New Mexico,2016,2092789,2578,25261,18146,2683,-7176,-4493,7115,12.0779345,8.676069806,3.40186469,1.282811379,-3.431030361,-2.148218982
New Mexico,2017,2093395,606,24088,18269,2330,-7514,-5184,5819,11.50833313,8.728235548,2.780097578,1.11318566,-3.589904314,-2.476718654
New Mexico,2018,2095428,2033,23803,18198,2342,-5851,-3509,5605,11.36500635,8.688836936,2.676169416,1.118213875,-2.793624844,-1.675410969
New York,2010,19400080,21956,61420,35126,19141,-22636,-3495,26294,0,0,0,0,0,0
New York,2011,19498514,98434,243113,149752,87879,-82398,5481,93361,12.49983483,7.699609914,4.800224913,4.518363826,-4.236554154,0.281809672
New York,2012,19574549,76035,239922,146900,90870,-107485,-16615,93022,12.28068555,7.519246699,4.761438846,4.651286233,-5.501744258,-0.850458025
New York,2013,19628043,53494,239872,152576,78677,-111926,-33249,87296,12.23755817,7.7839751,4.453583069,4.013867246,-5.710132636,-1.69626539
New York,2014,19656330,28287,237032,148844,85344,-145183,-59839,88188,12.06749564,7.577771446,4.489724196,4.344933799,-7.391386901,-3.046453102
New York,2015,19661411,5081,239363,153820,85244,-165895,-80651,85543,12.17582668,7.824457667,4.351369017,4.336159598,-8.438684206,-4.102524608
New York,2016,19641589,-19822,235826,151568,88905,-193186,-104281,84258,12.00040709,7.712795461,4.287611633,4.524082131,-9.830598173,-5.306516042
New York,2017,19590719,-50870,230364,160681,67949,-188585,-120636,69683,11.74358643,8.191259102,3.552327332,3.463930799,-9.613760169,-6.14982937
New York,2018,19542209,-48510,227099,165728,70375,-180306,-109931,61371,11.60654271,8.470002551,3.136540154,3.596715278,-9.215052858,-5.61833758
North Carolina,2010,9574293,38557,29914,18663,4656,20593,25249,11251,0,0,0,0,0,0
North Carolina,2011,9656754,82461,121036,79941,10029,30724,40753,41095,12.58756219,8.313743916,4.273818269,1.043000935,3.195249848,4.238250783
North Carolina,2012,9749123,92369,119573,79506,21892,29749,51641,40067,12.32338018,8.194012566,4.129367614,2.25622372,3.065978415,5.322202135
North Carolina,2013,9843599,94476,119381,84316,19502,39304,58806,35065,12.18625978,8.606869428,3.579390347,1.990739214,4.012102045,6.002841259
North Carolina,2014,9933944,90345,120194,83478,18228,34784,53012,36716,12.15459372,8.441695715,3.712898008,1.84330278,3.517524902,5.360827682
North Carolina,2015,10033079,99135,120832,88440,21672,44664,66336,32392,12.10315629,8.858606513,3.244549776,2.170779289,4.473776587,6.644555876
North Carolina,2016,10156679,123600,120839,89161,20960,70785,91745,31678,11.97032674,8.832300021,3.138026716,2.076300271,7.011971119,9.08827139
North Carolina,2017,10270800,114121,120077,91567,20640,64795,85435,28510,11.75641889,8.965080811,2.79133808,2.020807364,6.343905677,8.364713042
North Carolina,2018,10383620,112820,118784,93060,20035,66991,87026,25724,11.50204169,9.011146283,2.490895411,1.940020586,6.486843978,8.426864565
North Dakota,2010,674710,2134,2338,1496,434,813,1247,842,0,0,0,0,0,0
North Dakota,2011,685136,10426,9211,6054,1077,5991,7068,3157,13.54712225,8.903949418,4.64317283,1.584002894,8.811291867,10.39529476
North Dakota,2012,701116,15980,9873,5935,1137,10571,11708,3938,14.2441634,8.562656718,5.681506681,1.640394387,15.25119531,16.8915897
North Dakota,2013,721999,20883,10252,6224,1096,15341,16437,4028,14.40783071,8.747009202,5.660821508,1.540283111,21.55974746,23.10003057
North Dakota,2014,737382,15383,10980,6210,787,9531,10318,4770,15.04747561,8.510457516,6.537018092,1.078539463,13.06170219,14.14024165
North Dakota,2015,754022,16640,11404,6348,2068,9344,11412,5056,15.29297226,8.512783927,6.780188333,2.773225766,12.53047464,15.30370041
North Dakota,2016,754353,331,11333,6164,1409,-6287,-4878,5169,15.02676722,8.173033894,6.853733322,1.868235684,-8.336123312,-6.467887627
North Dakota,2017,755176,823,11182,6054,2659,-6997,-4338,5128,14.8152172,8.021044975,6.794172222,3.522953186,-9.27044131,-5.747488124
North Dakota,2018,760077,4901,10869,6213,2597,-2379,218,4656,14.3461191,8.200610723,6.145508374,3.427810405,-3.140069678,0.287740727
Ohio,2010,11539327,2570,34809,26552,3342,-8654,-5312,8257,0,0,0,0,0,0
Ohio,2011,11543463,4136,137927,110676,14680,-37755,-23075,27251,11.95063508,9.589482034,2.36115305,1.271943296,-3.271268335,-1.999325038
Ohio,2012,11548369,4906,137682,111412,17524,-38549,-21025,26270,11.92473599,9.649472593,2.275263392,1.517766109,-3.338756319,-1.82099021
Ohio,2013,11576576,28207,139089,114516,24116,-19895,4221,24573,12.02934753,9.904110042,2.125237487,2.085713069,-1.720652741,0.365060328
Ohio,2014,11602973,26397,139560,111897,20842,-21196,-354,27663,12.0416493,9.654803896,2.386845404,1.798309363,-1.828853529,-0.030544166
Ohio,2015,11617850,14877,139546,118280,24567,-30303,-5736,21266,12.01903998,10.18740809,1.831631894,2.115945675,-2.609985012,-0.494039337
Ohio,2016,11635003,17153,138674,117533,24390,-28034,-3644,21141,11.92748262,10.1091251,1.818357515,2.097807095,-2.411231,-0.313423905
Ohio,2017,11664129,29126,136206,118051,19421,-8133,11288,18155,11.69193771,10.13351055,1.558427155,1.667100732,-0.698137596,0.968963136
Ohio,2018,11689442,25313,134734,117359,20514,-12146,8368,17375,11.5386208,10.05062566,1.487995134,1.756819118,-1.040183533,0.716635584
Oklahoma,2010,3759632,8049,13148,8179,1215,1545,2760,4969,0,0,0,0,0,0
Oklahoma,2011,3787821,28189,52554,37673,6712,6626,13338,14881,13.92628745,9.982970414,3.943317037,1.778613262,1.755824117,3.534437379
Oklahoma,2012,3818600,30779,52346,36952,6622,8672,15294,15394,13.7636347,9.716001783,4.047632914,1.741160527,2.280178812,4.02133934
Oklahoma,2013,3853205,34605,53345,38616,5678,13996,19674,14729,13.9067664,10.06699206,3.839774343,1.480225319,3.648685023,5.128910341
Oklahoma,2014,3878367,25162,53079,38623,6538,4275,10813,14456,13.73045482,9.990982429,3.739472387,1.691247265,1.105855316,2.797102582
Oklahoma,2015,3909831,31464,53529,39728,9408,8324,17732,13801,13.74618365,10.20210323,3.544080415,2.415963231,2.137593318,4.553556548
Oklahoma,2016,3926769,16938,52856,39265,7764,-4333,3431,13591,13.48952352,10.02092744,3.468596075,1.981471557,-1.105836715,0.875634842
Oklahoma,2017,3932640,5871,51758,39769,4406,-10472,-6066,11989,13.17096489,10.12009936,3.05086553,1.121203897,-2.664831414,-1.543627517
Oklahoma,2018,3943079,10439,50778,40050,4272,-4474,-202,10728,12.89482268,10.17049999,2.724322694,1.084853332,-1.136150236,-0.051296904
Oregon,2010,3837532,6457,11881,7799,1606,986,2592,4082,0,0,0,0,0,0
Oregon,2011,3871728,34196,45394,32516,10421,10918,21339,12878,11.77648698,8.435569692,3.340917287,2.703502022,2.832437873,5.535939896
Oregon,2012,3899118,27390,44912,32946,4418,11098,15516,11966,11.5591018,8.479385642,3.07971616,1.137070533,2.85631706,3.993387593
Oregon,2013,3922908,23790,44991,33414,3407,8870,12277,11577,11.50366925,8.54356659,2.960102664,0.871129807,2.267954619,3.139084427
Oregon,2014,3964106,41198,45474,33812,6943,22447,29390,11662,11.53136028,8.574094074,2.95726621,1.760615615,5.692141538,7.452757153
Oregon,2015,4016918,52812,45681,35357,5343,36822,42165,10324,11.44740324,8.860266552,2.587136688,1.338925932,9.227387363,10.5663133
Oregon,2016,4091404,74486,45598,35317,12755,51262,64017,10281,11.24720997,8.711296863,2.535913103,3.146150338,12.64429311,15.79044345
Oregon,2017,4146592,55188,45389,35933,8167,37490,45657,9456,11.01942754,8.723723585,2.295703955,1.982763769,9.101728139,11.08449191
Oregon,2018,4190713,44121,45166,36052,8177,26819,34996,9114,10.83467619,8.648358193,2.186318001,1.961545128,6.433493797,8.395038924
Pennsylvania,2010,12711158,8285,36121,30214,5457,-1693,3764,5907,0,0,0,0,0,0
Pennsylvania,2011,12744583,33425,142975,127699,27481,-8176,19305,15276,11.2332224,10.03302163,1.200200772,2.159120019,-0.642369829,1.51675019
Pennsylvania,2012,12766827,22244,142120,125499,25615,-18630,6985,16621,11.14168131,9.838656507,1.303024803,2.008121072,-1.460522958,0.547598114
Pennsylvania,2013,12776621,9794,141805,130945,29587,-29890,-303,10860,11.10304294,10.25272704,0.850315901,2.316601893,-2.340326177,-0.023724283
Pennsylvania,2014,12789101,12480,142202,126713,34772,-36475,-1703,15489,11.12442668,9.91272611,1.211700573,2.720204812,-2.853430073,-0.133225262
Pennsylvania,2015,12785759,-3342,141913,132623,31937,-43725,-11788,9290,11.09785156,10.37135687,0.726494691,2.497530778,-3.419373557,-0.921842778
Pennsylvania,2016,12783538,-2221,140256,129938,38222,-50399,-12177,10318,10.9706575,10.16359582,0.807061688,2.98967938,-3.942149837,-0.952470457
Pennsylvania,2017,12790447,6909,137428,133891,31291,-27426,3865,3537,10.74748421,10.47087499,0.276609218,2.447096141,-2.144835856,0.302260285
Pennsylvania,2018,12807060,16613,135905,133562,35377,-20463,14914,2343,10.6186122,10.43554749,0.183064702,2.764097301,-1.598827573,1.165269727
Rhode Island,2010,1053938,981,2873,2338,1669,-1174,495,535,0,0,0,0,0,0
Rhode Island,2011,1053536,-402,11003,9767,4491,-6155,-1664,1236,10.44188446,9.268916248,1.172968207,4.261974288,-5.841115952,-1.579141664
Rhode Island,2012,1054601,1065,11009,9321,4411,-4996,-585,1688,10.44429276,8.842878807,1.60141395,4.184737519,-4.739729913,-0.554992394
Rhode Island,2013,1055122,521,10869,9636,3825,-4505,-680,1233,10.30372234,9.134848509,1.168873829,3.626068446,-4.270702836,-0.64463439
Rhode Island,2014,1056017,895,10726,9696,3495,-3534,-39,1030,10.16133945,9.185562864,0.975776583,3.311008891,-3.347955772,-0.03694688
Rhode Island,2015,1056173,156,10876,10071,4541,-5143,-602,805,10.29831597,9.536073933,0.762242033,4.299802575,-4.869827052,-0.570024477
Rhode Island,2016,1057063,890,10902,9822,4276,-4443,-167,1080,10.31782536,9.295696269,1.022129095,4.046874083,-4.204925527,-0.158051443
Rhode Island,2017,1056486,-577,10768,9816,2410,-3908,-1498,952,10.18949644,9.288641995,0.90085444,2.280524369,-3.698045326,-1.417520956
Rhode Island,2018,1057315,829,10575,9830,2755,-2639,116,745,10.00567225,9.300780916,0.704891331,2.60667868,-2.496923788,0.109754892
South Carolina,2010,4635656,10275,14180,9675,1178,4477,5655,4505,0,0,0,0,0,0
South Carolina,2011,4671422,35766,57475,42035,2742,17335,20077,15440,12.35081515,9.032910222,3.317904932,0.589228972,3.725121891,4.314350863
South Carolina,2012,4717112,45690,57522,42075,5917,23939,29856,15447,12.25367028,8.963060687,3.290609588,1.26047368,5.099624712,6.360098392
South Carolina,2013,4764153,47041,56560,44661,5153,29597,34750,11899,11.93089741,9.420894786,2.510002621,1.086985756,6.243259734,7.330245489
South Carolina,2014,4823793,59640,57287,44521,6332,39857,46189,12766,11.94979613,9.286869158,2.662926971,1.320825128,8.313980909,9.634806037
South Carolina,2015,4892253,68460,58277,46825,7406,49011,56417,11452,11.99603213,9.638694588,2.357337543,1.52448846,10.08867187,11.61316033
South Carolina,2016,4958235,65982,57757,47248,5123,50184,55307,10509,11.72672867,9.593027269,2.133701396,1.040151513,10.18913987,11.22929138
South Carolina,2017,5021219,62984,56668,49134,5706,49600,55306,7534,11.35693396,9.847031711,1.509902245,1.143549537,9.940423594,11.08397313
South Carolina,2018,5084127,62908,56238,49776,5490,50775,56265,6462,11.13034625,9.851419239,1.278927016,1.086553593,10.04913637,11.13568996
South Dakota,2010,816165,1967,3032,1927,169,679,848,1105,0,0,0,0,0,0
South Dakota,2011,823484,7319,11796,7295,1245,1563,2808,4501,14.38844533,8.898245905,5.490199427,1.518617704,1.9065056,3.425123304
South Dakota,2012,833496,10012,11891,7433,2107,3356,5463,4458,14.35261741,8.971743775,5.380873638,2.543180968,4.050742918,6.593923886
South Dakota,2013,842270,8774,12059,7291,91,3836,3927,4768,14.39222421,8.701692241,5.690531972,0.108607049,4.578204833,4.686811882
South Dakota,2014,849088,6818,12440,7172,1069,408,1477,5268,14.71007321,8.480759248,6.22931396,1.264073011,0.482452562,1.746525573
South Dakota,2015,853933,4845,12255,7753,1610,-1226,384,4502,14.3920715,9.104996357,5.287075145,1.89075766,-1.439794342,0.450963318
South Dakota,2016,862890,8957,12321,7770,3173,1251,4424,4551,14.35325599,9.051602873,5.301653112,3.696362409,1.457343011,5.15370542
South Dakota,2017,873286,10396,12093,7374,3678,2006,5684,4719,13.93061533,8.494530508,5.436084821,4.236897642,2.310825631,6.547723272
South Dakota,2018,882235,8949,11943,7293,3659,638,4297,4650,13.60621719,8.308644556,5.297572629,4.168563065,0.72684975,4.895412815
Tennessee,2010,6355301,9015,19659,14307,1000,2839,3839,5352,0,0,0,0,0,0
Tennessee,2011,6397410,42109,78616,60208,8646,15053,23699,18408,12.32930002,9.442384447,2.886915574,1.355946983,2.360752941,3.716699924
Tennessee,2012,6451281,53871,80309,60638,7918,26026,33944,19671,12.50072867,9.438782519,3.061946155,1.232499093,4.051151981,5.283651074
Tennessee,2013,6493432,42151,80283,63491,9920,15067,24987,16792,12.403983,9.809564724,2.594418277,1.532672065,2.327900201,3.860572266
Tennessee,2014,6540826,47394,80453,63546,7558,22614,30172,16907,12.34485308,9.750612578,2.594240501,1.159713119,3.469932849,4.629645968
Tennessee,2015,6590808,49982,81879,66104,10051,24065,34116,15775,12.47049682,10.06790168,2.402595138,1.53080721,3.665195055,5.196002265
Tennessee,2016,6645011,54203,81259,66636,7649,31894,39543,14623,12.27865083,10.06904068,2.20961015,1.155803052,4.819346653,5.975149706
Tennessee,2017,6708794,63783,80204,67384,9043,41875,50918,12820,12.01215684,10.09210484,1.920052,1.354370533,6.27162071,7.625991244
Tennessee,2018,6770010,61216,79474,67259,8994,39952,48946,12215,11.79244093,9.979965582,1.81247535,1.334539771,5.928122406,7.262662177
Texas,2010,25242679,96565,92759,40966,15567,28034,43601,51793,0,0,0,0,0,0
Texas,2011,25646227,403548,381742,168090,71953,117054,189007,213652,15.00295565,6.606154984,8.39680067,2.827846211,4.600373999,7.42822021
Texas,2012,26089620,443393,378109,169149,88080,143712,231792,208960,14.61690576,6.538947744,8.077958016,3.404989194,5.555606348,8.960595542
Texas,2013,26489464,399844,384420,178632,83041,108849,191890,205788,14.62254458,6.794793154,7.827751431,3.158708509,4.140391643,7.299100152
Texas,2014,26977142,487678,394325,180772,110340,160926,271266,213553,14.75032846,6.76205256,7.988275897,4.127436105,6.019682641,10.14711875
Texas,2015,27486814,509672,402277,187892,121124,172520,293644,214385,14.77222844,6.899682425,7.872546019,4.447859058,6.335199008,10.78305807
Texas,2016,27937492,450678,400968,188835,115228,122969,238197,212133,14.46903097,6.814158395,7.654872575,4.158031316,4.437367245,8.59539856
Texas,2017,28322717,385225,395212,196396,103032,82801,185833,198816,14.04943234,6.981701757,7.067730587,3.662695245,2.94350133,6.606196575
Texas,2018,28701845,379128,391451,200500,104976,82569,187545,190951,13.72920672,7.032057519,6.697149204,3.681781896,2.895910012,6.577691908
Utah,2010,2775334,11443,13752,3687,959,477,1436,10065,0,0,0,0,0,0
Utah,2011,2814216,38882,51925,15008,2673,-567,2106,36917,18.57931318,5.370020843,13.20929234,0.956427619,-0.202878586,0.753549034
Utah,2012,2853467,39251,50448,15475,5024,-662,4362,34973,17.80198363,5.460785298,12.34119833,1.772858503,-0.233605161,1.539253342
Utah,2013,2897927,44460,51852,16280,3322,5657,8979,35572,18.03110689,5.661236215,12.36987068,1.155198201,1.967175262,3.122373463
Utah,2014,2937399,39472,50830,16277,5315,-202,5113,34553,17.4214774,5.578780003,11.84269739,1.821663434,-0.069233493,1.752429941
Utah,2015,2982497,45098,51014,17247,3951,7597,11548,33767,17.23476223,5.826791552,11.40797068,1.334820747,2.566599143,3.90141989
Utah,2016,3042613,60116,50623,17785,7371,19871,27242,32838,16.80400856,5.903626656,10.9003819,2.446760308,6.596062147,9.042822455
Utah,2017,3103118,60505,50317,17187,8973,18359,27332,33130,16.37461841,5.593150758,10.78146766,2.92007574,5.974553719,8.894629459
Utah,2018,3161105,57987,50124,17156,8967,16052,25019,32968,16.0032617,5.477455065,10.52580663,2.862924899,5.124977192,7.987902091
Vermont,2010,625880,136,1659,1330,86,-217,-131,329,0,0,0,0,0,0
Vermont,2011,626979,1099,6053,5431,1158,-636,522,622,9.662699474,8.669770501,0.992928973,1.848571946,-1.015277856,0.83329409
Vermont,2012,626063,-916,6087,5456,215,-1722,-1507,631,9.715556222,8.70840722,1.007149002,0.343164874,-2.748511223,-2.405346349
Vermont,2013,626212,149,5978,5559,321,-529,-208,419,9.547423689,8.8782416,0.669182089,0.512666946,-0.844862351,-0.332195404
Vermont,2014,625218,-994,6118,5607,291,-1721,-1430,511,9.777614409,8.960948675,0.816665734,0.465067962,-2.750453481,-2.285385519
Vermont,2015,625197,-21,5969,5934,2146,-2162,-16,35,9.54723032,9.491248905,0.055981414,3.432460423,-3.458051927,-0.025591504
Vermont,2016,623644,-1553,5834,5821,659,-2213,-1554,13,9.343062888,9.322243584,0.020819304,1.055378547,-3.544086077,-2.48870753
Vermont,2017,624525,881,5679,5738,1822,-852,970,-59,9.099729284,9.194267763,-0.09453848,2.919476449,-1.365199745,1.554276705
Vermont,2018,626299,1774,5599,5587,1850,-62,1788,12,8.952498513,8.933311161,0.019187352,2.958050053,-0.09913465,2.858915403
Virginia,2010,8023680,22625,25715,14668,5747,5493,11240,11047,0,0,0,0,0,0
Virginia,2011,8100469,76789,102344,60444,22666,12030,34696,41900,12.69449941,7.497325905,5.197173507,2.811435196,1.492171773,4.303606969
Virginia,2012,8185229,84760,102755,60214,36982,5020,42002,42541,12.61904771,7.394709149,5.224338558,4.541653665,0.616491845,5.158145509
Virginia,2013,8253053,67824,102539,63413,25574,3217,28791,39126,12.47563462,7.715283142,4.760351477,3.111517372,0.391403433,3.502920804
Virginia,2014,8312076,59023,102589,62633,34565,-15804,18761,39956,12.38613958,7.562029852,4.824109731,4.173224368,-1.90810467,2.265119698
Virginia,2015,8362907,50831,103237,65500,38389,-25452,12937,37737,12.3822615,7.856079973,4.526181526,4.604382505,-3.052716755,1.55166575
Virginia,2016,8410946,48039,102906,65592,35636,-24951,10685,37314,12.26981064,7.820743392,4.449067248,4.248993955,-2.974987321,1.274006634
Virginia,2017,8465207,54261,101529,67237,32541,-12485,20056,34292,12.03224455,7.968285189,4.063959363,3.856447616,-1.479602608,2.376845007
Virginia,2018,8517685,52478,99570,68820,31641,-9831,21810,30750,11.72591806,8.104626703,3.621291356,3.726220481,-1.157753344,2.568467137
Washington,2010,6742902,18362,22236,11825,5947,2304,8251,10411,0,0,0,0,0,0
Washington,2011,6821655,78753,86680,49850,19797,22109,41906,36830,12.78036577,7.350037307,5.430328466,2.918930563,3.259818953,6.178749516
Washington,2012,6892876,71221,86718,49438,21908,12300,34208,37280,12.64614882,7.209579387,5.436569431,3.194859525,1.793717919,4.988577444
Washington,2013,6962906,70030,87238,51321,19429,14660,34089,35917,12.59228819,7.407882139,5.184406048,2.804460982,2.116084101,4.920545084
Washington,2014,7052439,89533,87393,51268,30640,22944,53584,36125,12.47104513,7.315981162,5.155063967,4.372350449,3.27412561,7.646476059
Washington,2015,7163543,111104,88770,53858,32866,43178,76044,34912,12.48876089,7.577105824,4.911655065,4.623810019,6.074571563,10.69838158
Washington,2016,7294680,131137,89747,54693,29086,66774,95860,35054,12.41466534,7.56566004,4.849005303,4.023454335,9.236819767,13.2602741
Washington,2017,7425432,130752,90701,56067,31204,64662,95866,34634,12.32341167,7.617740952,4.705670718,4.239641655,8.78553098,13.02517264
Washington,2018,7535591,110159,90495,57568,30557,46549,77106,32927,12.09743478,7.695730432,4.401704349,4.084881094,6.222702819,10.30758391
West Virginia,2010,1854214,1213,5104,5233,82,1318,1400,-129,0,0,0,0,0,0
West Virginia,2011,1856074,1860,20466,21908,1867,1501,3368,-1442,11.0320277,11.80932585,-0.77729815,1.006390879,0.809101612,1.81549249
West Virginia,2012,1856764,690,20676,21492,890,730,1620,-816,11.13757185,11.57712779,-0.439555941,0.479417632,0.393230192,0.872647824
West Virginia,2013,1853873,-2891,20926,22253,634,-2124,-1490,-1327,11.27892596,11.99416704,-0.715241076,0.341720303,-1.144816914,-0.803096611
West Virginia,2014,1849467,-4406,20571,21666,996,-4254,-3258,-1095,11.10943095,11.70078902,-0.591358071,0.537892821,-2.297385603,-1.759492782
West Virginia,2015,1841996,-7471,20088,22782,1268,-5989,-4721,-2694,10.88348983,12.34307374,-1.45958391,0.686990497,-3.244783979,-2.557793482
West Virginia,2016,1830929,-11067,19416,22459,1037,-9046,-8009,-3043,10.57250012,12.22949012,-1.656990001,0.56467257,-4.925774417,-4.361101847
West Virginia,2017,1817048,-13881,18547,22629,332,-10107,-9775,-4082,10.16837551,12.40632822,-2.237952706,0.182018692,-5.541153357,-5.359134666
West Virginia,2018,1805832,-11216,18010,22551,386,-7029,-6643,-4541,9.942366294,12.44921168,-2.506845383,0.213090138,-3.880338294,-3.667248156
Wisconsin,2010,5690479,3197,17550,11754,1173,-3451,-2278,5796,0,0,0,0,0,0
Wisconsin,2011,5704755,14276,67791,48483,4062,-8869,-4807,19308,11.89813215,8.509346978,3.388785171,0.712929634,-1.556615687,-0.843686053
Wisconsin,2012,5719855,15100,67653,47888,5819,-10190,-4371,19765,11.84338021,8.383305863,3.460074348,1.018678099,-1.783868333,-0.765190234
Wisconsin,2013,5736952,17097,66892,50041,7967,-7347,620,16851,11.67725004,8.735592735,2.941657305,1.3907889,-1.2825563,0.108232599
Wisconsin,2014,5751974,15022,67067,49317,7732,-9988,-2256,17750,11.67506867,8.585136679,3.089931992,1.345991784,-1.738717788,-0.392726004
Wisconsin,2015,5761406,9432,67152,51258,9022,-15112,-6090,15894,11.66503668,8.904075085,2.760961594,1.567220052,-2.625119643,-1.057899592
Wisconsin,2016,5772958,11552,66787,51360,7657,-11395,-3738,15427,11.58052581,8.905562543,2.674963266,1.327684821,-1.975834992,-0.648150171
Wisconsin,2017,5792051,19093,65705,50587,7483,-3318,4165,15118,11.36272354,8.748285453,2.614438087,1.294075949,-0.573799813,0.720276136
Wisconsin,2018,5813568,21517,64939,50283,8051,-1011,7040,14656,11.19095845,8.665285324,2.525673124,1.387431381,-0.17422595,1.213205431
Wyoming,2010,564483,710,1994,1291,171,-232,-61,703,0,0,0,0,0,0
Wyoming,2011,567224,2741,7471,4450,-237,-47,-284,3021,13.20306404,7.864226341,5.338837703,-0.418836324,-0.083060368,-0.501896692
Wyoming,2012,576270,9046,7437,4379,463,5345,5808,3058,13.00750157,7.658982032,5.348519538,0.80979874,9.348540526,10.15833927
Wyoming,2013,582123,5853,7515,4616,479,2387,2866,2899,12.97487122,7.969661419,5.005209804,0.82700776,4.121226561,4.948234321
Wyoming,2014,582548,425,7709,4535,-243,-2528,-2771,3174,13.23807324,7.787606972,5.450466269,-0.417285225,-4.341140116,-4.758425341
Wyoming,2015,585668,3120,7797,4838,776,-604,172,2959,13.34855883,8.28271484,5.065843988,1.328521438,-1.034055346,0.294466092
Wyoming,2016,584290,-1378,7582,4797,421,-4601,-4180,2785,12.96114903,8.20029437,4.760854663,0.719683955,-7.865239607,-7.145555652
Wyoming,2017,578934,-5356,7150,4621,622,-8546,-7924,2529,12.29341898,7.945159316,4.348259665,1.069441483,-14.69364456,-13.62420308
Wyoming,2018,577737,-1197,6840,4947,597,-3686,-3089,1893,11.82704503,8.553858444,3.273186585,1.03227279,-6.373463154,-5.341190364
